0
0
--M#------------
--H#-##########-
-##############-
-#^############-
-#############^-
-###^##########-
-###########^##-
-#####^########-
-#########^####-
-#######^######-
-B##########-P--
----------------