0
0
--M#------------
--3#-##########-
-############K#-
-##----------##-
-###K#@########-
-##----------^#-
-###K####@#####-
-##----------##-
-###########--#-
-#####B#####-##-
-B##########-P--
----------------