0
0
--M#------------
--H#-#####BB##K-
-#@############-
--#-------------
-#@####---------
--#-------------
-#@####---------
--#-------------
-#@####---------
--##------------
--P#------------
----------------