0
0
----------------
-#####--###-#---
-[--^#######@^--
-#--#-##-----##-
-#--#----M#--##-
-####----H#-##--
---########--#--
-------------#--
------####--##--
--######K####@--
---#------------
---######B###P#-