0
0
--M#------------
--H#-##########-
-############K#-
-#######^######-
-####@#########-
-##############-
-#########^####-
-############@#-
-#####@########-
-##^########-##-
-###########-P--
----------------